haweran	age
meghalayan	age
northgrippian	age
greenlandian	age
rancholabrean	age
ionian	age
late pleistocene	age
wisconsinan	age
middle pleistocene	age
irvingtonian	age
castlecliffian	age
calabrian	age
nukumaruan	age
gelasian	age
blancan	age
early pleistocene	age
mangapanian	age
piacenzian	age
late pliocene	age
waipipian	age
zanclean	age
opoitian	age
early pliocene	age
hemphillian	age
kapitean	age
messinian	age
late miocene	age
tongaporutuan	age
tortonian	age
clarendonian	age
waiauan	age
serravallian	age
middle miocene	age
lillburnian	age
barstovian	age
langhian	age
clifdenian	age
altonian	age
burdigalian	age
early miocene	age
hemingfordian	age
arikareean	age
otaian	age
aquitanian	age
harrisonian	age
waitakian	age
chattian	age
late oligocene	age
monroecreekian  	age
duntroonian	age
geringian	age
whaingaroan	age
rupelian	age
early oligocene	age
whitneyan	age
orellan	age
priabonian	age
jacksonian	age
chadronian	age
late eocene	age
runangan	age
kaiatan	age
bortonian	age
bartonian	age
duchesnean	age
middle eocene	age
uintan	age
lutetian	age
porangan	age
heretaungan	age
ypresian	age
early eocene	age
bridgerian	age
mangaorapan	age
wasatchian	age
waipawan	age
teurian	age
thanetian	age
clarkforkian	age
selandian-thanetian	age
late paleocene	age
tiffanian	age
selandian	age
middle paleocene	age
danian	age
early paleocene	age
torrejonian	age
puercan	age
maastrichtian	age
haumurian	age
campanian	age
santonian	age
piripauan	age
coniacian	age
teratan	age
mangaotanean	age
turonian	age
arowhanan	age
cenomanian	age
ngaterian	age
motuan	age
albian	age
urutawan	age
korangan	age
aptian	age
barremian	age
hauterivian	age
valanginian	age
berriasian	age
portlandian	age
tithonian	age
puaroan	age
ohauan	age
kimmeridgian	age
heterian	age
oxfordian	age
callovian	age
temaikan	age
bathonian	age
bajocian	age
aalenian	age
toarcian	age
ururoan	age
pliensbachian	age
aratauran	age
sinemurian	age
hettangian	age
rhaetian	age
otapirian	age
norian	age
warepan	age
oretian	age
carnian	age
kaihikuan	age
ladinian	age
etalian	age
anisian	age
malakovian	age
scythian	age
olenekian	age
smithian	age
nelsonian	age
induan	age
dienerian	age
makarewan	age
tatarian	age
changhsingian	age
waiitian	age
dzhulfian	age
wuchiapingian	age
puruhauan	age
ochoan	age
kazanian	age
capitanian	age
flettian	age
wordian	age
barrettian	age
roadian	age
ufimian	age
kungurian	age
leonardian	age
mangapirian	age
wolfcampian	age
artinskian	age
telfordian	age
sakmarian	age
asselian	age
gzhelian	age
virgilian	age
stephanian	age
kasimovian	age
missourian	age
desmoinesian	age
moscovian	age
westphalian	age
atokan	age
bashkirian	age
morrowan	age
serpukhovian	age
chesterian	age
visean	age
meramecian	age
valmeyeran	age
osagean	age
tournaisian	age
kinderhookian	age
famennian	age
conewangan	age
chatauquan	age
chautauquan	age
cassadagan	age
senecan	age
frasnian	age
chemungian	age
fingerlakesian	age
givetian	age
tioughniogan	age
cazenovian	age
erian	age
eifelian	age
southwoodian	age
emsian	age
helderbergian	age
sawkillian	age
deerparkian	age
ulsterian	age
siegenian	age
pragian	age
gedinnian	age
lochkovian	age
cayugan	age
ludfordian	age
gorstian	age
niagaran	age
lockportian	age
homerian	age
sheinwoodian	age
telychian	age
alexandrian	age
aeronian	age
rhuddanian	age
ashgill	age
hirnantian	age
richmondian-hirnantian	age
gamachian	age
bolindian	age
richmondian	age
katian	age
eastonian	age
caradocian	age
maysvillian	age
edenian-maysvillian	age
edenian	age
shermanian	age
mohawkian	age
sandbian	age
gisbornian	age
rocklandian-shermanian	age
kirkfield	age
rocklandian	age
blackriverian	age
whiterock	age
rocklandian-kirkfield	age
llandeilo	age
chazyan	age
darriwilian	age
llanvirnian	age
arenigian	age
dapingian	age
yapeenian	age
castlemainian	age
floian	age
blackhillsian	age
chewtonian	age
bendigonian	age
tulean	age
lancefieldian	age
tremadocian	age
stairsian	age
skullrockian	age
warendan	age
trempealeauan	age
stage 10	age
datsonian	age
sunwaptan	age
payntonian	age
jiangshanian	age
iverian	age
franconian	age
steptoean	age
paibian	age
idamean	age
dresbachian	age
guzhangian	age
marjuman	age
mindyallan	age
boomerangian	age
drumian	age
undillan	age
floran	age
wuliuan	age
templetonian	age
delamaran	age
ordian	age
stage 4	age
dyeran	age
stage 3	age
montezuman	age
begadean	age
stage 2	age
fortunian	age
phanerozoic	eon
proterozoic	eon
archean	eon
hadean	eon
holocene	epoch
pleistocene	epoch
pliocene	epoch
late tertiary	epoch
miocene	epoch
oligocene	epoch
middle tertiary	epoch
eocene	epoch
early tertiary	epoch
paleocene	epoch
late cretaceous	epoch
early cretaceous	epoch
neocomian	epoch
late jurassic	epoch
middle jurassic	epoch
early jurassic	epoch
late triassic	epoch
middle triassic	epoch
early triassic	epoch
late permian	epoch
lopingian	epoch
guadalupian	epoch
early permian	epoch
cisuralian	epoch
pennsylvanian	epoch
late carboniferous	epoch
silesian	epoch
namurian	epoch
mississippian	epoch
early carboniferous	epoch
late devonian	epoch
middle devonian	epoch
early devonian	epoch
pridoli	epoch
ludlow	epoch
wenlock	epoch
llandovery	epoch
late ordovician	epoch
cincinnatian	epoch
middle ordovician	epoch
early ordovician	epoch
ibexian	epoch
late cambrian	epoch
furongian	epoch
epoch 3	epoch
miaolingian	epoch
middle cambrian	epoch
albertan	epoch
epoch 2	epoch
series 2	epoch
early cambrian	epoch
waucoban	epoch
terreneuvian	epoch
cenozoic	era
mesozoic	era
paleozoic	era
neoproterozoic	era
mesoproterozoic	era
paleoproterozoic	era
neoarchean	era
mesoarchean	era
paleoarchean	era
eoarchean	era
quaternary	period
neogene	period
tertiary	period
paleogene	period
cretaceous-paleogene	period
cretaceous	period
jurassic-cretaceous	period
jurassic	period
triassic-jurassic	period
triassic	period
permian	period
pennsylvanian-permian	period
carboniferous	period
devonian-mississippian	period
devonian	period
silurian-devonian	period
silurian	period
ordovician-silurian	period
ordovician	period
cambrian-ordovician	period
cambrian	period
hadrynian	period
ediacaran	period
vendian	period
cryogenian	period
tonian	period
neohelikian	period
stenian	period
ectasian	period
paleohelikian	period
calymmian	period
aphebian	period
statherian	period
orosirian	period
rhyacian	period
siderian	period
kenoran	period
sevatian	sub-age
alaunian	sub-age
lacian	sub-age
tuvalian	sub-age
julian	sub-age
spathian	sub-age
griesbachian	sub-age
late pennsylvanian	sub-epoch
middle pennsylvanian	sub-epoch
early pennsylvanian	sub-epoch
late mississippian	sub-epoch
middle mississippian	sub-epoch
early mississippian	sub-epoch
precambrian-phanerozoic	supereon
neoproterozoic-paleozoic	supereon
proterozoic-paleozoic	supereon
precambrian-paleozoic	supereon
neoproterozoic-cambrian	supereon
proterozoic-cambrian	supereon
precambrian-cambrian	supereon
topazan	supereon
precambrian	supereon
late silurian	superepoch
early silurian	superepoch
elsonian	superepoch
hudsonian	superepoch
nn21	zone
nn20	zone
nn19	zone
nn18	zone
nn17	zone
nn16	zone
nn15	zone
nn14	zone
nn13	zone
nn12	zone
nn11	zone
nn10	zone
nn9	zone
nn8	zone
nn7	zone
nn6	zone
nn5	zone
nn4	zone
nn3	zone
nn2	zone
nn1	zone
np25	zone
np24	zone
np23	zone
np22	zone
np21	zone
np19-20	zone
np18	zone
np17	zone
np16	zone
np15	zone
np14	zone
np13	zone
np12	zone
np11	zone
np10	zone
np9	zone
np8	zone
np7	zone
np6	zone
np5	zone
np4	zone
np3	zone
np2	zone
np1	zone
cc26	zone
cc25	zone
jeletzkytes nebrascensis	zone
hoploscaphites nicolleti	zone
hoploscaphites birkelundae	zone
baculites clinolobatus	zone
cc24	zone
baculites grandis	zone
baculites baculus	zone
cc23	zone
baculites eliasi	zone
baculites jenseni	zone
baculites reesidei	zone
baculites cuneatus	zone
baculites compressus	zone
didymoceras cheyennense	zone
exiteloceras jenneyi	zone
didymoceras stevensoni	zone
cc22	zone
didymoceras nebrascense	zone
cc21	zone
baculites scotti	zone
cc20	zone
baculites reduncus	zone
baculites gregoryensis	zone
cc19	zone
baculites perplexus	zone
baculites sp. (smooth ii)	zone
baculites asperiformis	zone
baculites maclearni	zone
baculites obtusus	zone
cc18	zone
baculites sp. (weak flank ribs)	zone
baculites sp. (smooth)	zone
scaphites hippocrepis iii	zone
scaphites hippocrepis ii	zone
scaphites hippocrepis	zone
scaphites leei	zone
cc17	zone
desmoscaphites bassleri	zone
cc16	zone
desmoscaphites erdmanni	zone
cc15	zone
clioscaphites choteauensis	zone
clioscaphites vermiformis	zone
clioscaphites saxitonianus	zone
cc14	zone
scaphites depressus	zone
cc13	zone
scaphites ventricosus	zone
scaphites preventricosus	zone
cc12	zone
scaphites mariasensis	zone
prionocyclus germari	zone
scaphites nigricollensis	zone
scaphites whitfieldi	zone
cc11	zone
scaphites warreni	zone
prionocyclus macombi	zone
prionocyclus hyatti	zone
collingnoniceras praecox	zone
collingnoniceras woollgari	zone
mammites nodosoides	zone
vascoceras birchbyi	zone
pseudaspidoceras flexuosum	zone
cc10	zone
watinoceras devonense	zone
nigericeras scotti	zone
neocardioceras juddii	zone
burroceras clydense	zone
sciponoceras gracile (euomphaloceras septemseriatum)	zone
sciponoceras gracile (vasoceras diartianum)	zone
dunveganoceras conditum	zone
dunveganoceras albertense	zone
dunveganoceras problematicum	zone
dunveganoceras pondi	zone
pleisacanthoceras wyomingense	zone
cc9	zone
acanthoceras amphibolum	zone
acanthoceras bellense	zone
acanthoceras muldoonense	zone
acanthoceras granerosense	zone
conlinoceras tarrantense - conlinoceras gilberti	zone
mantelliceras dixoni	zone
neogastroplites maclearni	zone
neogastroplites americanus	zone
mantelliceras mantelli	zone
neogastroplites muelleri	zone
neogastroplites cornutus	zone
neogastroplites haasi	zone
arrhaphoceras briacensis	zone
mortoniceras perinflatum	zone
mortoniceras rostratum	zone
mortoniceras fallax	zone
cc8	zone
mortoniceras inflatum	zone
mortoniceras pricei	zone
diploceras cristatum	zone
euhoplites lautus	zone
euhoplites loricatus	zone
hoplites dentatus	zone
douvilleiceras mammillatum	zone
leymeriella schrammeni	zone
cc7	zone
hypacanthoplites jacobi	zone
parahoplites nutfieldiensis	zone
epicheloniceras martinoides	zone
tropaeum bowerbanki	zone
deshayesites deshayesi	zone
deshayesites forbesi	zone
parancyloceras bidentatum/parancyloceras scalare	zone
cc6	zone
simanocyloceras stolleyi	zone
ancyloceras inexum/s. pingue	zone
paracrioceras denckmanni	zone
paracrioceras elegans	zone
haplocrioceras fissicostatum	zone
cc5	zone
paracrioceras rarocinctum	zone
simbirskites variabilis	zone
simbirskites marginatus	zone
craspedodiscus gottschei	zone
cc4	zone
milanowskia speetonensis	zone
speetoniceras inversum	zone
endemoceras regale	zone
endemoceras noricum	zone
endemoceras amblygonium	zone
eleniceras paucinodum	zone
stolcoceras tuberulatum	zone
dichotomites	zone
prodichotomites	zone
polyptychites	zone
cc3	zone
paratollia/platylenticeras	zone
peregrinoceras albidum	zone
cc2	zone
surites stenomphalus	zone
surites icenii	zone
hectoroceras kochi	zone
runctonia runctoni	zone
cc1	zone
nj17	zone
subcraspedites lamplughi	zone
subcraspedites preplicomphalus	zone
subcraspedites primitivus	zone
paracraspedites oppressus	zone
titanites anguiformes	zone
galbanites kerberus	zone
galbanites okusensis	zone
glaucolithites glaucolithus	zone
progalbanites albani	zone
virgatopavlovia fittoni	zone
pavlovia rotunda	zone
pavlovia pallasioides	zone
nj16	zone
pectinatites hudlestoni	zone
pectinatites wheatleyensis	zone
pectinatites scitulus	zone
nj15	zone
pectinatites elegans	zone
aulacostephanus autissiodorensis	zone
aulacostephanus eudoxus	zone
aulacostephanus mutabilis	zone
rasenia cymodoce	zone
pictonia baylei	zone
ringsteadia pseudocordata	zone
perisphinctes cautisnigrae	zone
nj14	zone
perisphinctes pumilus	zone
perisphinctes plicatilis	zone
cardioceras cordatum	zone
nj13	zone
quenstedtoceras mariae	zone
nj12	zone
quenstedtoceras lamberti	zone
peltoceras athleta	zone
erymnoceras coronatum	zone
kosmoceras jason	zone
sigloceras calloviense	zone
prolanulites koenigi	zone
nj11	zone
macrocephalites herveyi	zone
clydoniceras discus	zone
oxycerites orbis	zone
procerites hodsoni	zone
morrisiceras morrisi	zone
tulites subcontractus	zone
procerites progracilis	zone
zigzagiceras zigzag	zone
nj10	zone
parkinsonia parkinsoni	zone
garantiana garantiana	zone
strenoceras niortense	zone
stephanoceras humphriesianum	zone
witchellia laeviuscula	zone
hyperlioceras discites	zone
nj9	zone
graphoceras concavum	zone
brasilia bradfordensis	zone
nj8	zone
ludwigia murchisonae	zone
leioceras opalinum	zone
pleydellia aalensis	zone
dumortieria levesquei	zone
grammoceras thouarsense	zone
haugia variabilis	zone
nj7	zone
hildoceras bifrons	zone
harpoceras falciferum	zone
dactylioceras tenuicostatum	zone
nj6	zone
pleuroceras spinatum	zone
nj5	zone
amaltheus margaritatus	zone
nj4	zone
prodactylioceras davoei	zone
tragophylloceras ibex	zone
nj3	zone
uptonia jamesoni	zone
echinoceras raricostatum	zone
oxynoticeras oxynotum	zone
nj2	zone
asteroceras obtusum	zone
caenisites turneri	zone
arnioceras semicostatum	zone
arietites bucklandi	zone
nj1	zone
schlotheimia angulata	zone
alsatites liasicus	zone
psiloceras planorbis	zone
misikella posternstenini	zone
choristoceras crickmayi	zone
norigondolella sp.	zone
chochloceras amoenum	zone
cypriodella mosheri	zone
cypriodella bidentata	zone
gnomohalorites cordilleranus	zone
cypriodella serrulata	zone
mesohimavatites columbianus	zone
cypriodella postera	zone
cypriodella spiculata	zone
cypriodella multidentata	zone
drepanites rutherfordi	zone
epigondolella triangularis	zone
juvavites magnus	zone
malayites dawsoni	zone
epigondolella quadrata	zone
stikinoceras kerri	zone
metapolygnathus primitius	zone
klamathites macrolobatus	zone
metapolygnathus nodosus	zone
tropites welleri	zone
metapolygnathus carpathicus	zone
tropites dilleri	zone
metapolygnathus polygnathiformis	zone
metapolygnathus tadpole	zone
sirenites nanseni	zone
austrotrachyceras obesum	zone
tachyceras desatoyense	zone
daxatina canadensis	zone
metapolygnathus intermedius	zone
paragondolella inclinata	zone
frankites sutherlandi	zone
budurovignathus hungaricus	zone
macl. maclearni	zone
meginoceras meginae	zone
tuchodiceras poseidon	zone
budurovignathus truempyi	zone
eoprotrachyceras matutinum	zone
paragondolella excelsa	zone
frechites chischa	zone
eogymnotoceras deleeni	zone
anagymnotoceras varium	zone
neogondolella? regalis	zone
lenotropites caurus	zone
siberlingites mulleri	zone
chiosella timorensis	zone
chiosella gondolelloides	zone
triassospathodus sosioensis	zone
neospathodus triangularis	zone
icriospathodus collinsoni	zone
olenikites pilaticus	zone
bajarunia eumphala	zone
neospathodus pingdingshanensis	zone
borinella buurensis-scythogondolella milleri	zone
anawasatchites tardus	zone
euflemingites romunderi	zone
neospathodus waageni	zone
hedenstroemia hedenstroemi	zone
neospathodus dieneri morph 3	zone
vavilovites sverdrupi	zone
proptychites candidus	zone
sweetospathodus kummeli	zone
neogondollela krystyni	zone
proptychites rosenkrantzi strigatus	zone
isarcicella isarcica	zone
ophiceras commune	zone
hindeodus parvus	zone
upper otoceras boreale	zone
clarkina zhejiangensis-clarkina meishanensis	zone
lower otoceras boreale	zone
clarkina deflecta-clarkina yini	zone
clarkina changxingensis	zone
clarkina subarinata	zone
clarkina wangi	zone
clarkina longicuspidata	zone
clarkina orientalis	zone
clarkina transcaucasica	zone
clarkina guangyuanensis	zone
clarkina leveni	zone
clarkina asymmetrica	zone
clarkina dukouensis	zone
clarkina postitteri postitteri	zone
clarkina postitteri hongshuiensis	zone
jinogondolella granti	zone
jinogondolella prexuanhanensis	zone
jinogondolella altudaensis	zone
jinogondolella shannoni	zone
jinogondolella postserrata	zone
jinogondolella aserrata	zone
jinogondolella nankingensis	zone
mesogondolella lamberti-neostreptognathodus sulcoplicatus	zone
sweetognathus guizhouensis	zone
neostreptognathodus prayi	zone
neostreptognathodus pnevi	zone
sweetognathus clarki	zone
neostreptognathodus pequopensis	zone
sweetognathus whitei	zone
sweetognathus anceps-mesogondolella bisselli	zone
sweetognathus binodosus	zone
sweetognathus merrilli-mesogondolella uralensis	zone
streptognathodus postfusus	zone
streptognathodus fusus	zone
streptognathodus constrictus-mesogondolella belladontae	zone
streptognathodus sigmoidalis-streptognathodus cristellaris	zone
streptognathodus isolatus	zone
streptognathodus wabaunsensis	zone
streptognathodus simplex-streptognathodus bellus	zone
streptognathodus virgilicus	zone
streptognathodus vitali	zone
streptognathodus simulator	zone
streptognathodus firmus	zone
idiognathodus toretzianus	zone
streptognathodus cancellosus	zone
idiognathodus sagittalis	zone
streptognathodus subexcelsus	zone
neoghanthodus round-streptognathodus cancellosus	zone
neoghanthodus medexultimus-streptognathodus-concinnus	zone
streptognathodus dissectus	zone
neognathodus uralicus	zone
declinognathodus donetzianus	zone
neognathodus atokaensis	zone
declinognathodus marginodosus	zone
idiognathodus sinuosus	zone
neognathodus askynensis	zone
idiognathoides sinuatus	zone
declinognathodus noduliferus	zone
gnathodus postbilineatus	zone
gnathodus bollandensis	zone
lochriea cruciformis	zone
lochriea ziegleri	zone
lochriea nodosa	zone
lochriea mononodosa	zone
gnathodus bilineatus	zone
gnathodus praebillineatus	zone
gnathodus texanus	zone
gnathodus pseudosemiglaber-scallioganthus anchoralis	zone
gnathodus semiglaber-polygnathus communis	zone
dollimae bouckaerti	zone
gnathodus typicus-siphonodella isosticha	zone
siphonodella quadruplicata-patrognathus andersoni	zone
siphonodella sandbergi-siphonodella belkai	zone
siphonodella duplicata	zone
siphonodella sulcata	zone
siphonodella praesulcata	zone
palmatolepis gracilis expansa	zone
palmatolepis perlobata postera	zone
palmatolepis rugosa trachytera	zone
palmatolepis marginifera	zone
palmatolepis rhomboidea	zone
palmatolepis crepida	zone
palmatolepis triangularis	zone
palmatolepis linguiformis	zone
palmatolepis rhenana	zone
palmatolepis hassi	zone
palmatolepis punctata	zone
palmatolepis transitans	zone
mesotaxis guanwushanensis	zone
klapperina disparilis	zone
schmidtognathus hermanni	zone
polygnathus varcus	zone
polygnathus hemiansatus	zone
polygnathus ensensis	zone
tortodus knockelianus knockelianus	zone
polygnathus costatus costatus	zone
polygnathus costatus partitus	zone
polygnathus costatus patulus	zone
linguipolygnathus serotinus	zone
polygnathus inversus	zone
eocostapolygnathus nothoperbonus	zone
eocostapolygnathus gronbergi	zone
eocostapolygnathus excavatus	zone
eocostapolygnathus kitabicus	zone
eocostapolygnathus pireneae	zone
gondwania kindlei	zone
gondwania irregularis	zone
pedavis gilberti	zone
masaraella pandora morpho. beta	zone
ancryodelloides trigonicus	zone
leanea transitans	zone
lanea eleanorae	zone
lanea omoalpha	zone
caudicriodus postwoschmidti	zone
caudicriodus hesperius	zone
oulodus elegans detortus	zone
ozarkodina eosteinhornensis	zone
ozarkodina crispa	zone
ozarkodina snajdri	zone
polygnathoides siluricus	zone
ancoradella ploeckensis	zone
kockelella variabilis variabilis	zone
kockelella crassa	zone
kockelella ortus obsidata	zone
ozarkodina bohemica longa	zone
ozarkodina sagitta sagitta	zone
kockelella ortus ortus	zone
kockelella walliseri	zone
ozarkodina sagitta rhenana	zone
kockelella ranuliformis	zone
pterospathodus pennatus procerus	zone
pterospathodus amorphognathoides amorphognathoides	zone
pterospathodus amorphognathoides lithuanicus	zone
pterospathodus amorphognathoides lennarti	zone
pterospathodus amorphognathoides angulatus	zone
pterospathodus eopennatus	zone
distomodus staurognathoides	zone
pterospathodus tenuis	zone
aspelunda expansa	zone
distomodus kentuckyensis	zone
aphelognathus shatzeri	zone
aphelognathus divergens	zone
aphelognathus grandis	zone
oulodus robustus	zone
oulodus velicuspis	zone
belodina confluens	zone
plectodina tenuis	zone
phragmodus undatus	zone
belodina compressa	zone
erismodus quadridactylus	zone
plectodina aculeata	zone
cahabagnathus sweeti	zone
cahabagnathus friendsvillensis	zone
phragmodus polonicus	zone
histiodella holodentata	zone
histiodella sinuosa	zone
histiodella altifrons	zone
microzarkodina flabellum/tripodus laevus	zone
reutterodus andinus	zone
oepikodus communis	zone
acodus delatus/oneotodus costatus	zone
macerodus dianae	zone
rossodus manitouensis	zone
cordylodus angulatus	zone
symphysurina bulbosa	zone
iapetognathus fluctivagus	zone
symphysurina brevispicata	zone
missisquoia	zone
eurekia apopsis	zone
saukiella serotina	zone
saukiella junia/saukiella pyrene	zone
ellipsocephaloides-idahoia	zone
taenicephalus	zone
elvinia	zone
dunderbergia	zone
aphelaspis	zone
crepicephalus	zone
cedaria	zone
bolaspidella	zone
ptychagnostus gibbus	zone
ptychagnostus praecurrens	zone
albertella	zone
plagiura-poliella	zone
amecephalus arrojosensis	zone
eokochaspis nodosa	zone
olenellus	zone
nevadella	zone
fallotaspis	zone
fritzaspis	zone
wyattia	zone